100000000000002
001-20000000000
00|0|0000000000
00|0|0000000000
P-40|0000000000
0000|0001-----K
0000|000|000000
00003---4000000
000000000000000
300000000000004